+##########################################################+
#                                                       #  #
# ####### ##### ####### ###### ###### ##   ## ## ###### #  #
# ##   ## ##### ##   ## ##%%%# ##     ####### ##   ##   #  #
# ## # ## ##    ## # ## ##%%%# ###### ## # ## ##   ## ###  #
# ## # ## ##### ## # ## ##%%%# ##     ##   ## ##   ## ###  #
# ## # ## ##### ## # ## ###### ###### ##   ## ##   ## ###  #
!    #                                         #           !
# ############ ######## ############# ######## ########### #
# ############ ######## ############# ######## ########### #
!                                              ##          !
# ######## ######## ##       ######## ##    ## ## ##    ## #
# ######## ##       ##       ######## ##    ## ## ##    ## #
#   ####   ######## ##       ##    ## ##    ## ## ##    ## #
# # #### # ######## ##       ## ## ## ##    ## ## ##    ## #
# # #### # ##       ######## ## ## ##  ##  ##  ##  ##  ##  #
# # #### # ######## ######## ## ## ##   ####   ##   ####   #
# #      #                                                 #
+##########################################################+