+##########################################################+
#.......................................................#..#
#.#######.#####.#######.######.######.##...##.##.######.#..#
#.##...##.#####.##...##.##   #.##.....#######.##...##...#..#
#.##.#.##.##....##.#.##.##   #.######.##.#.##.##...##.###..#
#.##.#.##.#####.##.#.##.##   #.##.....##...##.##...##.###..#
#.##.#.##.#####.##.#.##.######.######.##...##.##...##.###..#
!....#.........................................#...........!
#.############.########.#############.########.###########.#
#.############.########.#############.########.###########.#
!..............................................##..........!
#.########.########.##.......########.##....##.##.##....##.#
#.########.##.......##.......########.##....##.##.##....##.#
#...####...########.##.......##....##.##....##.##.##....##.#
#.#.####.#.########.##.......##.##.##.##....##.##.##....##.#
#.#.####.#.##.......########.##.##.##..##..##..##..##..##..#
#.#.####.#.########.########.##.##.##...####...##...####...#
#.#......#.................................................#
+##########################################################+