+##########################################################+
#                                                          #
#  ######    #####    ######   ######   #   # #### #     # #
#  #######  #######   #######  #######  ##  # #    #     # #
#  ##  ###  ##   ##   ##  ###  ##  ###  # # # #### #     # #
#     ###   ##   ##     ###       ###   #  ## #     # # #  #
!   ###     ##   ##    ###       ###    #   # ####  ## ##  !
#  #######  #######   #######   ######                     #
# ########   #####   ########  #######  ################## #
#                                                          #
! #  # #### #### #### #   #     #   # ####   ### ####   #  !
# #  # #%%# #%%# #%%# #   #     #   # #     #%%# #%%#   #  #
# #### #### #### #### #####     ##### ####  #### ####   #  #
# #  # #  # #    #      #         #   #     #  # # #    #  #
# #  # #  # #    #      #         #   ####  #  # #  #   #  #
#                                                          #
# #### #### ##### #### ####     ####  ####  #### ####   #  #
#                                                          #
+##########################################################+