"##################################################",
"#$***********************************************#",
"#************************************************#",
"#*****##############***%%%%%%%%%****##############",
"#*****##############***%%%%@%%%%****##############",
"#**********************%%%%%%%%%*****************#",
"#************************************************#",
"#*******#######**********************************#",
"#******######****####################************#",
" *****######*****#%%%%%%%%%%%%%%%%%%#************ ",
" *****######*****#                  #************ ",
" ******######****####################************ ",
"#*******#######**********************************#",
"#*********************######*********************#",
"#**************#####*********#####***************#",
"#*********************######*********************#",
"#******##################################********#",
"#************************************************#",
"##################################################",
