"####################      ########################",
"#$***********************************************#",
"#************************************************#",
"#*****##############***%%%%%%%%%****##############",
"#*****##############***%%%%@%%%%****##############",
"#**********************%%%%%%%%%******************#",
"#*************************************************#",
"#*********###########*****************************#",
"#*******#######***********************************#",
"#******######****####################*************#",
" *****######*****#                  #************ ",
" *****######*****#                  #************ ",
" ******######****####################************ ",
"#*******#######**********************************#",
"#*********##########*****************************#",
"#*********************######*********************#",
"#**************#####*********#####***************#",
"#**************#####*********#####***************#",
"#*********************######*********************#",
"#******##################################********#",
"#******##################################********#",
"#************************************************#",
"#************************************************#",
"####################      ########################",

